GPE	ORG	PERSON	NORP
MGI)-	OTE NO ON PROP	Doris Boss	Imaginese
L.A. County's	GSMOL	Doris	Californian
Los Angeles	Social Security	LIBRARY	Una
Garden Grove	como	P.O. Box	Sino
LOS ANGELES	ZY QUE SI	cuarto de billar	
California	para compartir	su manera de vivir	
Sacramento	Seria	detenga su	
vigila	un	aproximalamente de ‘ 80,000	
el estacionamiento	casa	contra el mundo de problemas	
Garden	seria de su	Sacarle el agua	
el cuarto de barraja	el derecho de vender su casa	Negarles el derecho de publicar	
la fecha	Sin	Concuerda	
Perderia el status de “	Asistentes de los Directores	Negarle	
Legislador	la ventana que diga	Podra	
Perderia	Aumentar la renta	para discutir	
Capitulos	El duefio	de la organizacion de GSMOL	
La	Cerrar el	para llamar	
al jacuzzi	la biblioteca	su casa esta de venta	
California	La junta Directiva 	el derecho de que viva alguna	
los gastos	Cobrarle	al costo de el	
la	como dueno solitario de mobile	Negar de	
	Directores Regionales	Supongamos	
	Defensor Legislativo	nosotros perderiamos	
	Cerrar	tendra que ir	
	el administrador la vendera	Que seria de su	
		podra	
		ponerlo bajo	
