GPE	NORP	ORG	PERSON
los duenos de mobilehomes	desean	park-- muchos	jEN EFECTO
LOS OFICIALES	Informatine	UN	LO-
casas	JUNTESE	la renta	se completarian de poseer
LA		EL CONTROL LOCAL DE RENTA	DE MODO QUELOS
San Luis Obispo		Golden State Mobilhome Owners League	estan debajo del ataque
Pomona		ELLOS	DE MILES DE ANCIANOS
San Bernardino		los ancianos de mobilehome	Pocos
medida		DE LA RENTA	DE MODO
Rancho Mirage		los cantroles locales de renta	casas decomisadas
Fremont		SIN	Paula
Watsonville		casi	tratar de
Thousand Oaks		Viviendo de ingresos bajos	Qué
ciento		LA INICIATIVA DE LA RENTA	nueva ordenanza protectora de renta de mobilehome
Morgan Hill		"RECUERDA DE LA INICIATIVA DE ""NO FUMAR"	Pretendiendo
Fairfield		CALES DE RENTA YA	Condado de Santa Cruz
Fontana		LA INICIATIVA	Condado de Sonoma
Cathedral City		la renta pierden	Estado Jack O'Connel
Colton		ASISTENCIA DE RENTA	Condado de Ventura
LA		VOTANTES	La Verne
Fresno		Escondido	limitada de diez
Yucaipa		debajo de Ia renta	Barbara
San Jose		por la iniciativa de la renta	Carson
San Marcos		Oxnard	Lompoc
los duefos de mobilehome de ingresos		las familias de ingresos	Condado de Riverside
California		un	de la iniciativa
Daly City		Arroyo Grande	Rohnert Park
Chino		Miembro de Asamblea Juanita	secuestrado el proceso porlos
Ontario		neutrales cerca de esta medida	Lan
Upland		Palmdale	Palm Desert
Vacaville		oponemos la iniciativa de renta	Sta
Rialto		el parque	Redlands
Union City		Merced, Montclair	Clarita
Azusa		la reduccién de	Rosa Demécrata
Salinas		POR FAVOR	Miembro de Asamblea
San Juan Capistrano		CON ESTOS COMPETIDORES	AQUI UNAS
		McDonald Miembro de Asambiea	Condado de Alameda
		Capitola	John Vasconcellos
		Clovis	
